30,25
28,4,2,15,17,7,19,16
4
8,8,10,12,15,10,14,6
20,5,22,8,27,8,26,4
6,15,8,20,13,18,12,14
18,18,20,24,28,23,29,16