50,24
2,22,48,2
14
4,4,5,9,8,10,9,5
8,12,8,17,13,12
11,1,11,6,14,6,14,1
11,8,15,8,15,11,11,11
2,15,2,17,5,18,5,14
6,23,9,20,12,23
16,14,14,18,18,21,20,18
17,5,17,12,21,12,21,5
24,11,22,17,25,22,30,20,29,15
33,5,30,10,38,10
26,2,24,5,26,9,28,5
36,1,36,5,43,5,43,1
34,12,34,19,39,19,39,12
41,8,41,21,45,21,45,8